3
10 9 4 5
. . . . . . . . . .
. . . . . . . . . .
. . . . . . . . . .
. . . . . * * * . .
. . * . * . . . . .
. . * * . . . . . .
. . . . . . . . . .
. . . . . . . . . .
. . . . . . . . . .
. . . . . . . . . .
10 9 5 5
. . . . . . . . . .
. . . . . . . . . .
. . . . . . . . . .
. . . * . . . * . .
. . . . * . * . . .
. . . . . 0 . . . .
. . . . * . * . . .
. . . * . . . * . .
. . . . . . . . . .
. . . . . . . . . .
8 9 5 5
 . . . . . . . .
 . . . . . . . .
 . . . . . . . .
 . . . . . . . .
 . . . . . * . .
 . . . . . 0 . .
 . . . . * . * *
 . . . . . . * *